0 368 405 0 365 367 407 405 407 407 368 365 0 408 367 368 365 0 368 368 405 365 0 407 0 0 0 0 407 408 367 408 367 405 365 407 408 407 365 407 0 0 368 365 408 407 408 408 407 407 408 407
408 407 368 368 365 0 367 405 405 365 365 408 408 367 408 365 0 408 407 0 408 0 0 365 368 0 365 365 0 368 0 407 0 408 0 367 367 367 405 407 368 405 368 367 407 365 0 365 408 405 368 368
365 405 368 0 408 407 405 405 408 407 408 0 407 407 368 0 368 0 408 367 368 0 367 365 0 0 367 408 407 367 368 367 0 365 367 0 368 365 405 408 365 0 365 407 368 368 408 365 368 407 367 407
0 407 365 367 365 405 408 408 367 407 408 0 368 405 407 367 0 368 367 0 0 0 0 408 408 407 0 407 365 0 0 365 367 365 407 408 368 365 0 407 408 405 0 368 407 0 408 368 408 408 405 405
368 407 0 0 408 368 0 405 405 368 365 365 367 0 368 365 368 367 367 368 405 405 367 367 0 368 0 405 405 408 368 407 368 368 405 0 407 405 407 405 365 367 0 408 368 405 0 407 405 365 368 407
0 0 0 368 407 407 405 405 407 405 407 365 367 408 368 368 365 408 405 407 368 368 0 120 121 121 121 121 121 121 121 121 122 407 368 407 367 368 0 365 408 405 405 407 407 408 365 408 0 407 405 405
365 0 408 365 407 405 407 0 365 407 365 368 407 365 365 368 120 121 121 121 121 121 121 281 161 161 161 161 161 161 161 161 280 121 121 121 121 121 121 121 122 0 0 407 408 405 405 408 407 368 405 0
365 408 408 367 365 367 367 368 120 121 121 121 121 121 121 121 281 161 161 161 161 161 161 161 161 161 161 161 161 255 256 256 256 256 256 256 257 161 161 161 280 121 121 121 122 405 407 367 407 365 367 405
121 121 121 121 121 121 121 121 281 255 256 256 256 256 256 256 256 256 256 256 256 256 256 256 256 256 256 256 256 416 283 283 283 283 283 283 415 256 256 256 256 257 161 161 280 121 121 121 121 121 121 121
256 256 256 256 256 256 256 256 256 416 283 283 283 283 283 283 283 283 283 283 283 283 283 283 283 283 283 283 283 283 283 283 283 283 283 283 283 283 283 43 283 415 256 256 256 256 256 256 256 256 256 256
124 283 283 283 124 283 283 283 283 283 283 283 283 283 283 283 283 283 283 283 283 283 283 124 283 283 283 283 283 283 283 283 283 283 283 283 283 283 283 283 283 283 283 283 283 283 283 283 283 283 283 283
283 283 283 283 283 283 283 283 283 283 283 283 283 283 124 283 283 283 283 283 283 283 283 283 283 283 283 283 283 283 283 283 283 283 283 283 283 283 283 283 283 283 283 283 283 283 42 283 283 283 283 283
